R 1920 1080
NO ./textures/redbrick.xpm
WE ./textures/purplestone.xpm
SO ./textures/wood.xpm
EA ./textures/mossy.xpm
S ./textures/barrel.xpm


C 0,66,99
F 66,33,0



        1111111111111111111111111
        1000000000110000000000001
        101100000111000000200W001
        1001000000000000000000001
111111111011000001000000000000001
100000000011000001000111111111111
11110111111111010000000010001
11110111111111011101010010001
11000000110101011100000010001
10002000000000001100000010001
10000000000000001101010010001
1100000111010101111101111000111
11110111 1110101 101111000001
11111111 1111111 111111111111
