NO ./textures/mossy.xpm
SO ./textures/purplestone.xpm
WE ./textures/WE.xpm
EA ./textures/EA.xpm

C 1,1,1
F 225,12,0

        1111111111111111111111111
        1000000000110000000000001
        1011000001110000000000001
        1001000000000000000000001
111111111011000001110000000000001
100000000011000001110111111111111
11110111111111011100000010001
11110111111111011101010010001
11000000110101011100000010001
10000000000000001100000010001
10000000000000110101010010001
11000001110101011111011110N0111
11110111 1110101 101111010001
11111111 1111111 111111111111
