NO ./textures/mossy.xpm
SO ./textures/purplestone.xpm
WE ./textures/WE.xpm
EA ./textures/EA.xpm

S ./textures/barrel.xpm
C 100,233,10
F 0,0,0

        1111111111111111111111111
        1000000000110000000000001
        1011000001110000002000001
        10010000000000W0000000001
111111111011000001110000000000001
100000000011000001110111111111111
11110111111111011100000010001
11110111111111011101010010001
11000000110101011100000010001
10002002000000001100000010001
10000000002000110101010010001
1100000111010101111101111000111
11110111 1110101 101111010001
11111111 1111111 111111111111
